NO ./textures/n_wall.xpm
SO ./textures/s_wall.xpm
WE ./textures/w_wall.xpm
EA ./textures/e_wall.xpm

F 36,35,35
C 153,217,234

11111
1S001
10101
11001
11001
10001
101001
10001
10001
10001
11101
100001
100001
100001
100111
1011
10001
100001
100001
111001
110001
100001
100101
100001
100001
110001
100011
100111
101111
100111
100011
100001
111101
111001
110001
100001
100001
100001
10001
10001
11001
10001
10101
10001
10001
10001
11101
100001
100001
100001
100111
1011
10001
100001
100001
111001
110001
100001
100101
100001
100001
110001
100011
100111
101111
100111
100011
100001
111101
111001
110001
100001
100001
100001
10001
10001
11001
10001
10101
10001
10001
10001
11101
100001
100001
100001
100111
1011
10001
100001
100001
111001
110001
100001
100101
100001
100001
110001
100011
100111
101111
100111
100011
100001
111101
111001
110001
100001
100001
100001
10001
10001
11001
10001
10101
10001
10001
10001
11101
100001
100001
100001
100111
1011
10001
100001
100001
111001
110001
100001
100101
100001
100001
110001
100011
100111
101111
100111
100011
100001
111101
111001
110001
100001
100001
100001
10001
10001
11001
10001
10101
10001
10001
10001
11101
100001
100001
100001
100111
1011
10001
100001
100001
111001
110001
100001
100101
100001
100001
110001
100011
100111
101111
100111
100011
100001
111101
111001
110001
100001
100001
100001
10001
10001
11001
10001
10101
10001
10001
10001
11101
100001
100001
100001
100111
1011
10001
100001
100001
111001
110001
100001
100101
100001
100001
110001
100011
100111
101111
100111
100011
100001
111101
111001
110001
100001
100001
100001
10001
10001
11001
10001
10101
10001
10001
10001
11101
100001
100001
100001
100111
1011
10001
100001
100001
111001
110001
100001
100101
100001
100001
110001
100011
100111
101111
100111
100011
100001
111101
111001
110001
100001
100001
100001
10001
10001
11001
10001
10101
10001
10001
10001
11101
100001
100001
100001
100111
1011
10001
100001
100001
111001
110001
100001
100101
100001
100001
110001
100011
100111
101111
100111
100011
100001
111101
111001
110001
100001
100001
100001
10001
10001
11001
10001
10101
10001
10001
10001
11101
100001
100001
100001
100111
1011
10001
100001
100001
111001
110001
100001
100101
100001
100001
110001
100011
100111
101111
100111
100011
100001
111101
111001
110001
100001
100001
100001
10001
10001
11001
10001
10101
10001
10001
10001
11101
100001
100001
100001
100111
1011
10001
100001
100001
111001
110001
100001
100101
100001
100001
110001
100011
100111
101111
100111
100011
100001
111101
111001
110001
100001
100001
100001
10001
10001
11001
10001
10101
10001
10001
10001
11101
100001
100001
100001
100111
1011
10001
100001
100001
111001
110001
100001
100101
100001
100001
110001
100011
100111
101111
100111
100011
100001
111101
111001
110001
100001
100001
100001
10001
10001
11001
10001
10101
10001
10001
10001
11101
100001
100001
100001
100111
1011
10001
100001
100001
111001
110001
100001
100101
100001
100001
110001
100011
100111
101111
100111
100011
100001
111101
111001
110001
100001
100001
100001
10001
10001
11001
10001
10101
10001
10001
10001
11101
100001
100001
100001
100111
1011
10001
100001
100001
111001
110001
100001
100101
100001
100001
110001
100011
100111
101111
100111
100011
100001
111101
111001
110001
100001
100001
10000110001
10001
11001
10001
10101
10001
10001
10001
11101
100001
100001
100001
100111
1011
10001
100001
100001
111001
110001
100001
100101
100001
100001
110001
100011
100111
101111
100111
100011
100001
111101
111001
110001
100001
100001
10000110001
10001
11001
10001
10101
10001
10001
10001
11101
100001
100001
100001
100111
1011
10001
100001
100001
111001
110001
100001
100101
100001
100001
110001
100011
100111
101111
100111
100011
100001
111101
111001
110001
100001
100001
10000110001
10001
11001
10001
10101
10001
10001
10001
11101
100001
100001
100001
100111
1011
10001
100001
100001
111001
110001
100001
100101
100001
100001
110001
100011
100111
101111
100111
100011
100001
111101
111001
110001
100001
100001
100001
10001
11001
10001
10101
10001
10001
10001
11101
100001
100001
100001
100111
1011
10001
100001
100001
111001
110001
100001
100101
100001
100001
110001
100011
100111
101111
100111
100011
100001
111101
111001
110001
100001
100001
100001
10001
11001
10001
10101
10001
10001
10001
11101
100001
100001
100001
100111
1011
10001
100001
100001
111001
110001
100001
100101
100001
100001
110001
100011
100111
101111
100111
100011
100001
111101
111001
110001
100001
100001
100001
10001
11001
10001
10101
10001
10001
10001
11101
100001
100001
100001
100111
1011
10001
100001
100001
111001
110001
100001
100101
100001
100001
110001
100011
100111
101111
100111
100011
100001
111101
111001
110001
100001
100001
100001
10001
11001
10001
10101
10001
10001
10001
11101
100001
100001
100001
100111
1011
10001
100001
100001
111001
110001
100001
100101
100001
100001
110001
100011
100111
101111
100111
100011
100001
111101
111001
110001
100001
100001
100001
11001
10001
10101
10001
10001
10001
11101
100001
100001
100001
100111
1011
10001
100001
100001
111001
110001
100001
100101
100001
100001
110001
100011
100111
101111
100111
100011
100001
111101
111001
110001
100001
100001
100001
10001
11001
10001
10101
10001
10001
10001
11101
100001
100001
100001
100111
1011
10001
100001
100001
111001
110001
100001
100101
100001
100001
110001
100011
100111
101111
100111
100011
100001
111101
111001
110001
100001
100001
100001
10001
11001
10001
10101
10001
10001
10001
11101
100001
100001
100001
100111
1011
10001
100001
100001
111001
110001
100001
100101
100001
100001
110001
100011
100111
101111
100111
100011
100001
111101
111001
110001
100001
100001
100001
10001
11001
10001
10101
10001
10001
10001
11101
100001
100001
100001
100111
1011
10001
100001
100001
111001
110001
100001
100101
100001
100001
110001
100011
100111
101111
100111
100011
100001
111101
111001
110001
100001
100001
100001
10001
11001
10001
10101
10001
10001
10001
11101
100001
100001
100001
100111
1011
10001
100001
100001
111001
110001
100001
100101
100001
100001
110001
100011
100111
101111
100111
100011
100001
111101
111001
110001
100001
100001
100001
10001
11001
10001
10101
10001
10001
10001
11101
100001
100001
100001
100111
1011
10001
100001
100001
111001
110001
100001
100101
100001
100001
110001
100011
100111
101111
100111
100011
100001
111101
111001
110001
100001
100001
100001
111111