NO ./textures/n_wall.xpm
SO ./textures/s_wall.xpm
WE ./textures/w_wall.xpm
EA ./textures/e_wall.xpm

F 0,0,0
C 153,217,234

11111111111111111111111111111111
1S000000001100000000000000000001
10110000011100000000000000000001
10010000000000000000000000000001
10010001111111111000000110000001
10010001111111111000000110000001
10010000000000000000000010000001
10010000000000000000000010000001
10010001111111111111111110000001
10010001111111111111111110000001
10010000000000000000000000000001
10010000000000000000000000000001
10110000011100000010000000000001
10000000001100000000000000000001
10010000000000000000000000000001
10010001111111111000000110000001
10010001111111111000000110000001
10010000000000000000000010000001
10010000000000000000000010000001
10010001111111111111111110000001
10010001111111111111111110000001
10010000000000000000000000000001
10010000000000000000000000000001
10110000011100000010000000000001
10000000001100000000000000000001
10010000000000000000000000000001
10010001111111111000000110000001
10010001111111111000000110000001
10010000000000000000000010000001
10010000000000000000000010000001
10010001111111111111111110000001
10010001111111111111111110000001
10010000000000000000000000000001
10010000000000000000000000000001
10110000011100000010000000000001
10000000001100000000000000000001
10010000000000000000000000000001
10010001111111111000000110000001
10010001111111111000000110000001
10010000000000000000000010000001
10010000000000000000000010000001
10010001111111111111111110000001
10010001111111111111111110000001
10010000000000000000000000000001
10010000000000000000000000000001
10110000011100000010000000000001
10000000001100000000000000000001
10110000011100000000000000000001
10010000000000000000000000000001
10010001111111111000000110000001
10010001111111111000000110000001
10010000000000000000000010000001
10010000000000000000000010000001
10010001111111111111111110000001
10010001111111111111111110000001
10010000000000000000000000000001
10010000000000000000000000000001
10110000011100000010000000000001
10000000001100000000000000000001
10110000011100000000000000000001
10010000000000000000000000000001
10010001111111111000000110000001
10010001111111111000000110000001
10010000000000000000000010000001
10010000000000000000000010000001
10010001111111111111111110000001
10010001111111111111111110000001
10010000000000000000000000000001
10010000000000000000000000000001
10110000011100000010000000000001
10000000001100000000000000000001
10110000011100000000000000000001
10010000000000000000000000000001
10010001111111111000000110000001
10010001111111111000000110000001
10010000000000000000000010000001
10010000000000000000000010000001
10010001111111111111111110000001
10010001111111111111111110000001
10010000000000000000000000000001
10010000000000000000000000000001
10110000011100000010000000000001
10000000001100000000000000000001
10110000011100000000000000000001
10010000000000000000000000000001
10010001111111111000000110000001
10010001111111111000000110000001
10010000000000000000000010000001
10010000000000000000000010000001
10010001111111111111111110000001
10010001111111111111111110000001
10010000000000000000000000000001
10010000000000000000000000000001
10110000011100000010000000000001
10000000001100000000000000000001
10110000011100000000000000000001
10010000000000000000000000000001
10010001111111111000000110000001
10010001111111111000000110000001
10010000000000000000000010000001
10010000000000000000000010000001
10010001111111111111111110000001
10010001111111111111111110000001
10010000000000000000000000000001
10010000000000000000000000000001
10110000011100000010000000000001
10000000001100000000000000000001
10110000011100000000000000000001
10010000000000000000000000000001
10010001111111111000000110000001
10010001111111111000000110000001
10010000000000000000000010000001
10010000000000000000000010000001
10010001111111111111111110000001
10010001111111111111111110000001
10010000000000000000000000000001
10010000000000000000000000000001
10110000011100000010000000000001
10000000001100000000000000000001
10110000011100000000000000000001
10010000000000000000000000000001
10010001111111111000000110000001
10010001111111111000000110000001
10010000000000000000000010000001
10010000000000000000000010000001
10010001111111111111111110000001
10010001111111111111111110000001
10010000000000000000000000000001
10010000000000000000000000000001
10110000011100000010000000000001
10000000001100000000000000000001
10110000011100000000000000000001
10010000000000000000000000000001
10010001111111111000000110000001
10010001111111111000000110000001
10010000000000000000000010000001
10010000000000000000000010000001
10010001111111111111111110000001
10010001111111111111111110000001
10010000000000000000000000000001
10010000000000000000000000000001
10110000011100000010000000000001
10000000001100000000000000000001
10110000011100000000000000000001
10010000000000000000000000000001
10010001111111111000000110000001
10010001111111111000000110000001
10010000000000000000000010000001
10010000000000000000000010000001
10010001111111111111111110000001
10010001111111111111111110000001
10010000000000000000000000000001
10010000000000000000000000000001
10110000011100000010000000000001
10000000001100000000000000000001
10110000011100000000000000000001
11111111111111111111111111111111