NO ./textures/n_wall.xpm
SO ./textures/s_wall.xpm
WE ./textures/w_wall.xpm
EA ./textures/e_wall.xpm

F 0,0,0
C 153,217,234


    11111111
  111S00000111
 11100100000011
1110001111100011
1110010000010011
1110010000010011
1110010000010011
1110010000010011
1110010000010011
1110010000010011
1110001111100011
 11100000000011
  111000000011
    11111111