NO ./textures/n_wall.xpm
SO ./textures/s_wall.xpm
WE ./textures/w_wall.xpm
EA ./textures/e_wall.xpm

F 0,0,0
C 153,217,234


11111111111111111111111111111111111111
11S000000000000000000000000000000000011
110000000000000000000000000000000000011
110000000000000000000000000000000000011
1100001111111111111111111111111111000011
11000011000000000000000000000110000111
1100001100000000000000000000011000011
1100001100000000000000000000011000011
1100001100001111111111111000011000011
1100001100001100000000011000011000011
1100001100001100000000011000011000011
1100001100001100000000011000011000011
1100001100001100000000011000011000011
1100001100001100000000011000011000011
1100001100001100000000011000011000011
1100001100001111111111111000011000011
1100001100000000000000000000011000011
1100001100000000000000000000011000011
11000011000000000000000000000110000111
1100001111111111111111111111111111000011
110000000000000000000000000000000000011
11111111111111111111111111111111111111