NO ./textures/n_wall.xpm
SO ./textures/s_wall.xpm
WE ./textures/w_wall.xpm
EA ./textures/e_wall.xpm

F 0,0,0
C 153,217,234


    111111111
1E00000111111111
100000001 1000001
1110011110001111
11110011110011
11111001110001
1111110011110011111111111111
1111111001110000000000000001
11111111000111111111111111011
111111111100111111111111110001
1111111111100111111111111111001
1111111111110011111111111111101
1111111111111001111111111111001
1111111111111100111111111110011
1111111111111110011111111100011
1111111111111111001111111000111
111111111111111110011110000111
11111111111111111100100000111
111111111111111111100000111
1111111111111111111111111111111