NO ./textures/n_wall.xpm
SO ./textures/s_wall.xpm
WE ./textures/w_wall.xpm
EA ./textures/e_wall.xpm

F 36,35,35
C 153,217,234

1111
1S01
1001
1001
1001
1001
1001
1001
1001
1111