NO ./textures/n_wall.xpm
SO ./textures/s_wall.xpm
WE ./textures/w_wall.xpm
EA ./textures/e_wall.xpm

F 0,0,0
C 153,217,234


   1111111111
   10000011111
   10000011111
   10000011111
1111000001
1S00000001
1000000001
1000000001
1000000001
1000000001
1000000001
1111111111